EDNNNN111111111100VDNNNN11111111111111111111RGNNNN
NNNNNN111111111100NNNNNN11111111111111111111NNNNNN
00000000000011110000000000000000000000000000000000
111111CBNN00111100JBNN00BBNN0011111111111111RGNNNN
111111NNNN00111100NNNN00NNNN0011111111111111NNNNNN
111111NNNN00111100NNNN00NNNN0011111111111111000000
11111111110011110011110011111111111111111111000000
11111111110011110011110011111111111111111111000000
11111111110011110011110011111111111111111111CGNNNN
11111111110011110011110011111111111111111111NNNNNN
11111111110011110011110011111111111111000000000000
SHNN00JDNNNN111100BHNN0011111111111111111111VGNNNN
NNNN00NNNNNN111100NNNN0011111111111111111111NNNNNN
NNNN00000000000000NNNN0000000000000000000000000000