EBNN111111VBNN111111BBNN00111111111111111111JGNNNN
NNNN111111NNNN111111NNNN00111111111111111111NNNNNN
NNNN111111NNNN111111NNNN00111111000000000000000000
11111111111111111111111100111111GGNNNN00GDNNNN1111
11111111111111111111111100111111NNNNNN00NNNNNN1111
0000000011111111000000000000000000000000000000CHNN
JDNNNN111111111111BGNNNN00CDNNNN11111111111100NNNN
NNNNNN111111111111NNNNNN00NNNNNN11111111111100NNNN
00000000000000000000000000000000000000111111000000
1111111111111111111111111100RDNNNN1111111111VGNNNN
RDNNNN11111111111111SGNNNN00NNNNNN1111111111NNNNNN
NNNNNN11111111111111NNNNNN000000000000000000000000
0000000000000000000000000000NNNNNNNNNNNNNNNNNNNNNN
NNNNNNNNNNNNNNNNNNNNNNNNNN00NNNNNNNNNNNNNNNNNNNNNN