MBNN1111VBNN00gBNN001111VBNN00CDNNNN11111111EGNNNN
NNNN1111NNNN00NNNN001111NNNN00NNNNNN11111111NNNNNN
NNNN1111NNNN00NNNN001111NNNN0000000000001111111111
11111111111111111100111111111111SGNNNN001111111111
11111111111111111100111111111111NNNNNN001111111111
00000000000011111100111100000000000000001111111111
11111111111111111100GHNN001111gBNN1111001111GGNNNN
11111111111111111100NNNN001111NNNN1111001111NNNNNN
11111111111111111100NNNN000000NNNN0000001111111111
11111111111111111111111111111111111111111111111111
11111111111111111111111111111111111111111111111111
CDNNNN11111111111111111111BHNN0000MHNN001111BGNNNN
NNNNNN11111111111111111111NNNN1111NNNN001111NNNNNN
00000000000000000000000000NNNN0000NNNN000000000000