EDNNNN11111111111111VBNN00111111111111RBNN11111111
NNNNNN11111111111111NNNN00111111111111NNNN11111111
0000NN11111111111111NNNN00111111111111NNNN11111111
0000NN11111111111111111100111111111111111111111111
RDNNNN11111111111111111100111111111111111111111111
NNNNNN11111111111111111100111111111111111111VGNNNN
00000000000000000000000000111111111111111111NNNNNN
111111111111111111NNNNNN00111111000000000000000000
111111111111111111JGNNNN00111111111111111111NNNNNN
111111111111111111NNNNNN00111111111111111111JGNNNN
SHNN0000000000000000000000111111111111111111NNNNNN
NNNNNNNNNNNNNNNNNNNNNNNN00000000000000000000000000
NNNNNNNNNNNNNNNNNNNNNNNN00NNNNNNNNNNNNNNNNNNNNNNNN
00000000000000000000000000NNNNNNNNNNNNNNNNNNNNNNNN