SDNNNN11111111111111111111111111111111111111EGNNNN
NNNNNN11111111111111111111111111111111111111NNNNNN
00000000000000RHNN1111111100BHNN001111111100000000
11111111111100NNNN1111111100NNNN001111111100111111
11111111111100NNNN1111000000NNNN000000BHNN00111111
1111111111110000001111CBNN000000001111NNNN11111111
1111111111110011111111NNNN11NN11111111NNNN11111111
11111100JHNN0011111111NNNN11NN111111110000VHNN1111
11111100NNNN0011111111111111001111GHNN0000NNNN1111
11111100NNNN0011111111111111001111NNNN0000NNNN1111
RHNN00000000000000000000000000JHNNNNNN00000000GHNN
NNNN00CDNNNN1111111111VGNNNN00NNNN000000000000NNNN
NNNN00NNNNNN1111111111NNNNNN00NNNN000000000000NNNN
00000000000000000000000000000000000000000000000000