SDNNNN111111111111111111VGNNNN00111111111111EGNNNN
NNNNNN111111111111111111NNNNNN00111111111111NNNNNN
00000000000000000000000000000000111111000000000000
RDNNNN11111111111100BBNN00JBNN0011111100CBNN111111
NNNNNN11111111111100NNNN00NNNN0011111100NNNN111111
00000011111111111100NNNN00NNNN0011111100NNNN111111
00000011111111111111111100111100111111001111111111
00000011111111111111111100111100111111001111111111
VDNNNN11111111111111111100111100111111001111111111
NNNNNN11111111111111111100111100111111000000JHNN00
00000000000011111111111100111100111111CGNNNNNNNN00
RDNNNN11111111111111111100BHNN00111111NNNNNNNNNN00
NNNNNN11111111111111111100NNNN00000000000000000000
00000000000000000000000000NNNN00000000000000000000