11111111111111111111111111111111111111111111111111
11111111111111111111111111111111111111111111111111
EDNNNN11111111111111111111111111111111111111RGNNNN
NNNNNN11111111111111111111111111111111111111NNNNNN
00000000000000000000000000000000000000000000000000
RDNNNN11111111111111111111111111111111111111BGNNNN
NNNNNN11111111111111111111111111111111111111NNNNNN
00000000000000000000000000000000000000000000000000
BDNNNN11111111111111111111111111111111111111111111
NNNNNN11111111111111111111111111111111111111111111
00000000000000000000000000000000000000000000SHNN00
11111111111111111111111111111111111111111111NNNN11
11111111111111111111111111111111111111111111NNNN11
00000000000000000000000000000000000000000000000000