11111111111111111111111111VGNNNN001111111111CGNNNN
11111111111111111111111111NNNNNN001111111111NNNNNN
1111000000000000000000000000000000111111111100VBNN
11111100RBNN00GDNNNN11111111111100111111111100NNNN
11111100NNNN00NNNNNN11111111111100JHNN11111100NNNN
11111100NNNN00000000111111SGNNNN00NNNN111111111111
11111111111111111100111111NNNNNN00NNNN111111111111
11111111111111111100000000000000000000000000000000
111111111111GGNNNN00CBNN00JDNNNN111111111111BGNNNN
RHNN11111111NNNNNN00NNNN00NNNNNN111111111111NNNNNN
NNNN1111000000000000NNNN00000000000000000000000000
NNNN1111111111111111111100BDNNNN111111111111EGNNNN
00001111111111111111111100NNNNNN111111111111NNNNNN
00000000000000000000000000000000000000000000000000