CDNNNN11111100MBNNCBNN0011111111111111111111111111
NNNNNN11111100NNNNNNNN0011111111111111111111111111
00000011111100NNNNNNNN0011111111111111111111BGNNNN
SDNNNN11111100111111110011111111111111111111NNNNNN
NNNNNN1111110011111111001111GHNNgHNN00000000000000
0000000000000000000000001111NNNNNNNN11111111MGNNNN
1111111111111111BGNNNN001111NNNNNNNN11111111NNNNNN
1111111111111111NNNNNN00gHNN00000000RHNN0000000000
RDNNNN111111111100JBNN00NNNN00JBNN00NNNN00GBNN0000
NNNNNN111111111100NNNN00NNNN00NNNN00NNNN00NNNN0000
000000000000000000NNNN00000000NNNN00000000NNNN0000
EDNNNN11111111111111110011111111111111111111111111
NNNNNN11111111111111110011111111111111111111111111
00000000000000000000000000000000000000000000000000