SDNNNN11111111111111CGNNNN00VDNNNN1111111111RGNNNN
NNNNNN11111111111111NNNNNN00NNNNNN1111111111NNNNNN
00000000000000000000000000000000000000000000000000
00000000JBNN00GBNN111111111111110011111111RBNN1111
00000000NNNN00NNNN111111111111110011111111NNNN1111
BBNN0000NNNN00NNNN1111111111EHNN0011111111NNNN1111
NNNN111111110011111111111111NNNN001111111111111111
NNNN111111110011111111110000NNNN000000111111111111
11111111111100GDNNNN111100000000VBNN00111111111111
11111111111100NNNNNN111100000000NNNN00111111111111
00000000000000000000gHNN00000000NNNN00111100000000
BDNNNN111111CGNNNN00NNNN00gDNNNN111100111111JGNNNN
NNNNNN111111NNNNNN00NNNN00NNNNNN111100111111NNNNNN
00000000000000000000000000000000000000000000000000