GBNN111111111111CGNNNN0011RBNN1100VDNNNN1111111111
NNNN111111111111NNNNNN0011NNNN1100NNNNNN1111111111
NNNN1111111111111111110011NNNN11001111111111111111
11111111000000000000000011111111000000000000001111
1111111111VGNNNN00SDNNNN1111111100RDNNNN1111111111
1111111111NNNNNN00NNNNNN1111111100NNNNNN1111111111
1111NNNN000000000000000000000000000000000000000000
11111111111111000000001111111111111111111111111111
11111111BGNNNN00gBNN00gDNNNN1111111111111111CGNNNN
11111111NNNNNN00NNNN00NNNNNN1111111111111111NNNNNN
MHNN000000000000NNNN000000000000000000000000000000
NNNN00GDNNNN1111111111MGNNNN00BDNNNN11111111EGNNNN
NNNN00NNNNNN1111111111NNNNNN00NNNNNN11111111NNNNNN
00000000000000000000000000000000000000000000000000