BBNN111100gBNN001111111100GBNN00JBNN00RBNN1111CBNN
NNNN111100NNNN000011110000NNNN00NNNN00NNNN1111NNNN
NNNN111100NNNNGBNN0000VBNNNNNN00NNNN00NNNN1111NNNN
11111111001111NNNN0000NNNN111100111111111111111111
11111111001111NNNN0000NNNN111100111111111111111111
000011110011111111BBNN1111111100111111000000000000
111111110011111111NNNN11111111001111111111RGNNNN00
111111110000000000NNNN00000000001111111111NNNNNN00
1111000000VBNN0011111111MGNNNN00111111111100000000
1111111100NNNN0011111111NNNNNN00111111111111111111
1111111100NNNN000000000000000000111111111111111111
gHNN111100111111CGNNNN00MDNNNN11111111EGNNNN00SHNN
NNNNJHNN00111111NNNNNN00NNNNNN11111111NNNNNN00NNNN
NNNNNNNN00000000000000000000000000000000000000NNNN