BBNN11111100JBNN110011001100GBNN00gBNN11MBNN11CBNN
NNNN11111100NNNN001100110011NNNN00NNNN11NNNN11NNNN
NNNN11111100NNNNGBNN1100VBNNNNNN00NNNN11NNNN11NNNN
1111111111001111NNNN0011NNNN1111001111111111111111
1111111111001111NNNN1100NNNN1111001111111111111111
00000011110011111111BBNN11111111001111000000000000
11111111110011111111NNNN11111111001111MBNN11001100
11111111110000000000NNNN00000000001111NNNN00110011
111100000000VBNN0011111111RGNNNN001111NNNN11001100
111111111100NNNN0011111111NNNNNN001111111111111111
111111111100NNNN0000000000000000001111111111111111
gHNN00JHNN00111111CGNNNN00RDNNNN111111EGNNNN00SHNN
NNNN11NNNN00111111NNNNNN00NNNNNN111111NNNNNN00NNNN
NNNN11NNNN000000000000000000000000000000000000NNNN