BDNNNN11111111111111111111111111111111111111RGNNNN
NNNNNN11111111111111111111111111111111111111NNNNNN
00000000000000111100000000000000111111000000000000
CDNNNN11111111111100111111111111111111111111111111
NNNNNN11111111111100111111111111111111111111111111
11111111111111111100CDNNNN11111111111111111111gBNN
11111111111111111100NNNNNN11111111111111111111NNNN
0000001111110000000000000000000000000000000000NNNN
RDNNNN111111JGNNNN00JDNNNN11111111VGNNNN0011111111
NNNNNN111111NNNNNN00NNNNNN11111111NNNNNN0011111111
0000000000000000000000000000000000000000000000EHNN
gDNNNN111111BGNNNN00VDNNNN111111111111SGNNNN00NNNN
NNNNNN111111NNNNNN00NNNNNN111111111111NNNNNN00NNNN
00000000000000000000000000000000000000000000000000