BDNNNN1111111100111111111111111111111111111100BBNN
NNNNNN1111111100111111111111111111111111111100NNNN
0000001111111100NNNNNN00EHNN111111111111111100NNNN
JBNN00111111111111111100NNNN1111111111111111111111
NNNN00111111111111111100NNNN00NNNNNNNN111111111111
NNNN0011111111111111110000000011111111NNNNNN000000
111111111111111111111100SBNN0011111111111111gGNNNN
111111111111111111111100NNNN0011111111111111NNNNNN
000000NNNNNNNNNN00000000NNNN001111NNNNNNNNNN000000
1111111111111111gGNNNN0011110011111111111111000000
1111111111111111NNNNNN0011110011111111111111000000
JHNN00NNNNNNNNNN00000000RHNN00NNNNNN11111111RGNNNN
NNNN00111111111111111100NNNN0011111111111111NNNNNN
NNNN00111111111111111100NNNN00NNNNNNNNNNNNNN000000